W W W W W O W S W W W W W W W W W W W W W W
W - - - - - - - - - - - - - - - - - - - - W
W - - - - - - - - - - - - - - - - - - - - W
W - - - - - - - - - - - - - - - - - - - - W
W - - P - - - - - - - - - - - - - - - - - W
W - - - - - - - - - - - - - - - - - - - - W
W - - - - - - - - - - - - - - - - - - - - W
W - - - - - - - - - - - - - - - - - - - - W
W - - - - - - - - - - - - - - - - - - - - W
W - - - - - - - - - - - - - - - - - - - - W
W W W W W W W W W W W W W W W W W W W W W W