W W W W W W W W W W W W W W W W W W 
W C - P - - - - - - - - W H - - - W
W H - - - W - - - - H - W E - H - W 
W - - H - W H C W W W - W W W W - W
W - - W - - - - H - - - - W - - - W
W - H H - W - H W H - W - W - W W W
W - - W C W - C W C - - W W - W C W
W W - W W W W W - - H C W H - H - W
W - - - - K - W - W - - - - - - - W 
W W W W W W W W W W W W W W W W W W 