W W W W W W W W W W W W W W W W W W 
W - - P - - - - - - - - W - - - - W
W - - - - - - - - - W - W K - - - W 
W - - H - H W C H - W - W W W W - W
W - - - - - - - H - W - - - - - - W
W - H H - W - H - H - - - W H W W W
W - - W - W - - - C - W W W - W - W
W W - W W W W W - W - C - W - W C W
W - - - - E - W - - - W - - - - - W 
W W W W W W W W W W W W W W W W W W 