W W W W O W W W W W W W W W W W W W W W
- - - - - - - - - - - - - - - - - - - -
- - - - - - - - - - - - - - - - - - - -
- - - - - - - - - - - - - - - - - - - - 
- - - P - - - - - - - - - - - - - E - - 
- - - - - - - - - - - - - - - - - - - -
- - - - - - - - - - S - - - - - - - - -
- - - - - - - - - - - - - - - - - - - -
- - - - - - - - - - - - - - - - - - - -
- - - - - - - - - - - - - - - - - - - -
W W W W W W W W W W W W W W W W W W W W