W W W W W O W W W W W W W W W W W W W W W W
W - - - - - - - - - - - - - - - - - - - - W
W - - - - - - - - - - - - - - - - - - - - W
W - - - - - - - - - - - - - - - - - - - - W
W - - P - - - - - - - - - - - - - E - - - W
W - - - - - - - - - - - - - - - - - - - - W
W - - - - - - - - - S - - - - - - - - - - W
W - - - - - - - - - - - - - - - - - - - - W
W - - - - - - - - - - - - - - - - - - - - W
W - - - - - - - - - - - - - - - - - - - - W
W W W W W W W W W W W W W W W W W W W W W W